{
    "header": {
            "name": "level-3",
            "grid": {
                "dimension": {
                        "X": 10,
                        "Y": 10
                },
                "nbObjectives": 3,
                "nbWarps": 0,
                "nbBonusObjectives": 0,
                "nbWalls": 6
            }
    },
    "grid": [
            [1, 0, 0, 0, 0, 0, 0, 0, 0, 0],
            [0, 0, 0, 0, 2, 0, 0, 0, 0, 0],
            [0, 0, 0, 0, 0, 0, 0, 0, 0, 0],
            [0, 0, 0, -1, -1, -1, -1, -1, -1, 0],
            [0, 0, 0, 0, 0, 0, 0, 0, 0, 0],
            [0, 2, 0, 0, 0, 0, 0, 0, 0, 0],
            [0, 0, 0, 0, 0, 1, 0, 0, 3, 0],
            [0, 0, 0, 0, 0, 0, 0, 0, 0, 0],
            [0, 0, 3, 0, 0, 0, 0, 0, 0, 0],
            [0, 0, 0, 0, 0, 0, 0, 0, 0, 0]
    ]
}